Aber  :  aber
Als  :  als
Anstatt  :  anstatt
Ausser  :  ausser
Außer  :  außer
Bevor  :  bevor
Beziehungsweise  :  beziehungsweise
Bis  :  bis
Da  :  da
Daher  :  daher
Damit  :  damit
Denn  :  denn
Deshalb  :  deshalb
Desto  :  desto
Doch  :  doch
Ehe  :  ehe
Entweder  :  entweder
Falls  :  falls
Indem  :  indem
Minus  :  minus
Nachdem  :  nachdem
Ob  :  ob
Obwohl  :  obwohl
Oder  :  oder
Oft  :  oft
Ohne  :  ohne
Plus  :  plus
Seit  :  seit
Seitdem  :  seitdem
Sobald  :  sobald
Sofern  :  sofern
Solang  :  solang
Sooft  :  sooft
Soviel  :  soviel
Soweit  :  soweit
Statt  :  statt
Trotzdem  :  trotzdem
Um  :  um
Umso  :  umso
Und  :  und
Unerachtet  :  unerachtet
Unfern  :  unfern
Ungeachtet  :  ungeachtet
Warum  :  warum
Weder  :  weder
Weshalb  :  weshalb
Wie  :  wie
Wo  :  wo
Womit  :  womit
Woran  :  woran
Wozu  :  wozu
Während  :  während
Zumal  :  zumal
Zu  :  zu
Zwar  :  zwar
Alldieweil  :  alldieweil
Allein  :  allein
Beziehentlich  :  beziehentlich
Dass  :  dass
Derweil  :  derweil
Dieweil  :  dieweil
Eh  :  eh
Folglich  :  folglich
Geschweige  :  geschweige
Gleichwohl  :  gleichwohl
Hingegen  :  hingegen
Indes  :  indes
Indessen  :  indessen
Insofern  :  insofern
Maßen  :  maßen
Nämlich  :  nämlich
Obgleich  :  obgleich
Obschon  :  obschon
Obzwar  :  obzwar
Qua  :  qua
Sintemal  :  sintemal
So  :  so
Sodass  :  sodass
Solang  :  solang
Sowie  :  sowie
Sowohl  :  sowohl
Vielmehr  :  vielmehr
Wenn  :  wenn
Wiewohl  :  wiewohl
Wofern  :  wofern
Wohingegen  :  wohingegen
